##############
#            #
#            #########
#    P ####          #
#    ###  ###        #
#                    #
#OX        XO#########
##############
