##############
#            #
#            #########
#    P X             #
#       #X           #
#                    #
#OX        XO#########
##############
