##############
#            #
#            #
#    P ####  #
#    ###  ####
#            #
#OX        XO#
##############
